14:14
18 17 18 0 0 0 17 0 0 17 64 86 0 18
17 18 0 0 0 0 17 0 0 17 0 0 0 18
18 0 0 96 0 0 0 0 0 17 17 32 32 18
0 0 0 0 0 0 17 0 0 0 0 0 0 0
0 32 32 0 0 0 17 32 32 0 0 0 0 0 
0 17 17 18 18 18 17 18 18 0 0 17 18 18 
62 17 0 0 0 0 0 32 0 0 0 17 18 59 
17 17 0 96 0 0 17 17 17 0 17 17 18 0 
0 0 0 0 0 0 17 32 17 32 32 32 17 0
0 32 32 32 0 0 17 0 17 32 86 32 17 0 
17 18 0 18 17 0 17 0 17 17 32 17 17 0 
17 96 0 0 17 0 0 0 17 0 0 0 0 0 
17 0 0 64 17 0 17 0 17 17 17 96 0 17
17 17 17 17 17 0 17 0 0 0 0 0 0 18 