14:14
0 0 0 0 86 17 0 0 0 0 32 32 17 18
0 96 18 17 17 17 0 0 0 0 0 32 17 17
0 0 18 57 0 0 0 0 0 0 0 96 0 0
0 0 18 17 17 0 0 0 0 0 0 0 0 0
0 0 18 18 17 17 32 32 17 17 0 0 0 0 
0 0 0 0 60 17 32 32 17 0 0 0 0 0
32 0 0 0 17 17 32 32 17 0 0 18 18 18
32 0 0 0 17 0 0 0 17 0 0 0 0 0
32 0 18 18 17 0 0 0 17 0 0 0 0 0
0 0 18 18 17 17 17 0 0 0 0 0 0 0
0 0 0 0 0 18 17 32 32 17 0 0 0 0
0 96 0 0 0 18 17 32 64 17 0 96 18 18
0 0 0 0 0 18 17 17 17 17 0 17 17 17
18 18 18 0 0 0 0 0 0 0 0 17 17 17