14:14
17 17 17 17 18 18 0 0 0 0 0 32 32 18
17 0 0 17 32 32 0 0 17 18 0 17 18 0
17 0 0 17 17 17 0 0 18 64 0 17 54 0
17 0 0 0 0 0 0 0 17 18 17 17 0 0
0 0 0 0 0 0 0 0 0 0 0 0 0 0
0 0 17 0 17 0 0 0 0 0 0 0 0 0  
0 0 17 32 17 0 0 0 0 0 0 0 0 0 
17 17 17 32 17 0 0 17 17 17 17 17 17 17 
0 0 0 0 17 0 0 18 18 18 18 18 18 18 
0 0 0 0 17 0 0 32 32 0 0 0 0 0 
0 0 51 0 17 0 0 17 18 0 0 0 64 0 
17 0 0 0 17 0 0 17 18 0 0 96 0 0 
18 17 0 0 17 0 0 17 18 0 0 0 0 32 
18 18 17 0 17 0 0 17 18 0 0 0 32 32 

