12:12
0 0 0 96 0 0 0 0 0 0 0 0
17 17 17 0 17 0 17 17 17 17 0 0
0 0 0 0 17 32 17 0 0 17 0 0
32 0 0 0 17 32 17 0 0 17 0 0
0 0 64 0 17 32 17 0 0 17 0 0
0 0 0 0 17 17 17 0 0 17 0 0
0 0 0 0 0 0 0 0 0 17 0 0
0 18 32 18 0 0 0 0 0 17 0 0
0 18 18 18 0 0 0 0 0 17 0 0
0 0 0 0 0 0 0 0 0 17 0 0
0 17 17 17 17 17 17 17 17 17 0 0
32 0 50 64 64 64 64 64 0 0 0 0
